NO ./assets/crystal.xpm
SO ./assets/crystal_imac.xpm
WE 	./assets/crystal_box.xpm

F 		79, 0,           45

EA ./assets/crystal_sign.xpm
C    45,0,0

111 1111111111111111111
101 1111100000000000001
101111000000000000000011111
1100001111111111111111
10000010000000000000011
1000000000000000000001
1000001W00000000000001
1111111111111111111111


