NO ./resources/ceiling2.png
SO ./resources/south.png
WE ./resources/west.png
EA ./resources/east.png
F 79,0,45
C 45,250,0

111111111111111
100000000000001
10000011111111111111111111111111111111111111111111111111111
10100010000000000000000000000000000000000000000000000000001
10010000000000000000000000000000000000000000000000000000001
10000010000000000000000000000000000000000000000000000000001
11111111111111111111111111100000000000000000000000000000001
                          100000000000000000000000000000001
                          100000000000000000000000000000001
                          100000000000000000000000000000001
                          100000000000000000000000000000001
                          100000000000000000000000000000001
                          100000000000000000000000000000001
                          100000000000000000000000000000001
                          1000000000000000000000000000E0001
                          100000000000000000000000000000001
                          100000000000000000000000000000001
                          100000000000000000000000000000001
                          100000000000000000000000000000001
                          100000000000000000000000000000001
                          100000000000000000000000000000001
                          100000000000000000000000000000001
                          100000000000000000000000000000001
                          100000000000000000000000000000001
                          100000000000000000000000000000001
                          111111111111111111111111111111111
