NO ./resources/crystal.xpm
SO ./resources/crystal_imac.xpm
WE ./resources/crystal_box.xpm
EA ./resources/crystal_sign.xpm
F 79,0,45
C 45,250,0

111111111111111
100000000000001
1000001111111111111111
1000001000000000000001
1000000000000E00000001
1000001000000000000001
1111111111111111111111
