NO ./resources/ds_textures/wall.png
SO ./resources/ds_textures/wall.png
WE ./resources/ds_textures/wall.png
EA ./resources/ds_textures/wall.png
F 79,0,45
C 45,250,0

111111111111111
100000000000001
10000011111111111111111111111111111111111111111111111111111
10100010000000000000000000000000000000000000000000000000001
100100D000N000000000000000000000000000000000e00000000000001
1000001000000000000000000000eeeeeeeeeeeeeeeeeeeeeeeeeeeeee1
11111111111111111111111111100000000000000000000000000000001
                          1000e0000000000000000000000000001
                          100000000000000000000000000000001
                          100000000000000000000000000000001
                          100000000000000000000000000000001
                          100000000000000000000000000000001
                          1000000000000000000000000000e0001
                          100000000000000000000000000000001
                          100000000000000000000000000000001
                          100000000000000000000000000000001
                          100000000000000000000000000000001
                          100000000000000000000000000000001
                          100000000000000000000000000000001
                          100000000000000000000000000000001
                          100000000000000000000000000000001
                          1000e0000000000000000000000000001
                          100000000000000000000000000000001
                          10000000000000000e000000000000001
                          100000000000000000000000000000001
                          111111111111111111111111111111111
