NO ./resources/ds_textures/wall.png
SO ./resources/ds_textures/wall.png
WE ./resources/ds_textures/wall.png
EA ./resources/ds_textures/wall.png
F 79,0,45
C 45,250,0


111111111111111
1N0000001000001
111011101011110
100010001000001
101110111011101
100010001000001
111011101110111
100001000010001
101111101110101
100000000000001
111111111111111
