NO ./resources/sky.png
SO ./resources/south.png
WE ./resources/west.png
EA ./resources/east.png
F 79,0,45
C 45,250,0

111111111111111
1N0000001000001
111011101011110
1e00100010000e1
101110111011101
100010001000001
111011101110111
1e00010000100e1
101111101110101
100000000000001
111111111111111
